1211111111111111111111111111111111111111111111
1001111110111000110000011100001111000001111111
1101110000000010111110111101111111011111101111
1100000110111110111110100000001111011000101111
1111111101111110000010001101101000011010101111
1111101101111110111011111101101011000010101011
1111101101111110110011111101101011011011101011
1111100000000010100110000001101011011000001011
1111111101101010101110111111100011011011111011
1000001101101010101110111111101011011001111011
1011101101101000100000111111101111011100000011
1011101101101010111111111000000111011111111011
1011100001101011111111111011110111000000001011
1011111101101100001111100000110111111111101111
1010000101101101111111111010110111000000001111
1010110101101101000000000010110111011111111111
1010110101101100111101111110110111000000001111
1010100101101110111101111110110111111111101111
1010101101101110000000011110111111000000001111
1010101101100011111101100000111111011111111111
1011101101110111111111101111111111000000001011
1011101101110111111101101111111111111111101011
1111011111110000000000000000101110001111000000
1111111111111111111111111111111111111111111131
