121111111111111111111
100000000000000000001
101111111111111111101
101000100000100000001
101111101010101111101
101000101010101000101
101010000010101010101
101011111110101010101
101010000000101010101
101010111111101010001
101010100000101111111
101010101010101000101
101010101010101010101
101010101010101010101
101010101010101010101
101010101010101010101
101000101010101010101
101111101010101010101
100000001010100010001
1111111111111111111311