1211111111111111111111111111111111111111
1000111101010000000000000111110000000001
1011111101010111111111111000110111111111
1000000101010000000011111010110000000011
1111110101011111111000000010111111111011
1000000101000000000101101010111110000001
1000000001111101110100101010000000000101
1111111101000001000110101011111111110101
1000000001011110011110101010001111110001
1011111111010000111110101010101000011101
1000000100011110000000101010101011011101
1111110101100101111110101010101001010001
1000000001111101110110101010000000000101
1111111100000001000110101011111111110101
1000000001011110011110101010001111110001
1011111111010000111110101010101000011111
1000000100011100000000101010101011011111
1111110101100101111110101010101001010001
1000000100000000000010101010101011010101
1011111111111111111010101010101011000101
1000000000000000000010001000100010101101
1111111111111111111111111111111111111131