121111111111111111111111111111111
100000000000000000000000000000001
101111101111111111111110111111101
100000101010000010000010100000101
101111101010111010111010101110101
101000001010101010101010101010101
101011111010101010101010101010101
101000001010101010101010101000101
101111101010101010101011101111101
101000101010101010101010000000001
101000101010101010101010111111111
101011101010101010101010100000101
101000000000100010101010101010101
101111111111111010101010101010101
100000101000000010101010101010101
111110101011101010101010101010101
101010001010101010101010101010101
101011111010101010101010101010101
101000000010101010101000101010001
101111111110101011101111101011111
100000000000001000000000001000001
1111111111111111111111111111111311