12111111111111111111111111111111111111111111111111111111111111111111111111111111111111111111111111
10000010001000000100000010000100000000000001000000010100010001000100010001000100000001000000000001
10111010101010000101111110010101111111110101011111010101010101010101010101010111110001011111111111
10101010101011110100000010010101000000000101010001010101010101010101010101010100010101010000000001
10101010101000010111111010010101011111111101010101010101010101010101010101010101010101010111111111
10101011101111010000000000010101010000000001010101010001000101010111010101010001010101010100010001
10100010000000010011111111110111011111111101010101011111111101010000010101011111010100010101010101
10100011111111110001000101000000001000001000010101000000000001010111110101010000010111110101010101
10100000000000000101010101011111101011101111110101011111111111010000000101010111110100000000000001
10111111111111111101010101010010001010001000000101000000000001011111111101010000000111111111111111
10000000000000000001010101010010111010111011111101111111111101010001000000011111111100000000000001
10111111111111111111010101011010000010000000000000000000000000010101011111110100000001111111111101
10000000000000000000010101000011111111111111111111111111111111110101010001000101111111000000000001
11111111111111111111110101000000010001000100010001000000000100000100010101010101000000011111111111
10100010001000000000000101111111010101010101010101011111010101111111110101010101011111110000000001
10101010101011111111111100010100000101010101010101010000010101000100000101010101000000000111111111
10101010101010001000000001010101111101010101010101010111110101010101111101010101111111111101000001
10101010101010101011111101010101000000010101010101010000000001010100000000010101000000000000010001
10001000101010101010000001010101011111110101010101011111111101010101111111110101111111111111111111
11111111101110101010111001010101000000000001010100000000000001010100000000000001000000010001000101
10000000000000101010101001010101111111111111010111111111111111010101111111111111011011010101010101
11111111111111101010101111010101000000000000000101000000000000010100000000000000010001010101010101
10000000000000001010100000010101011111111111111101011111111111110111110111111111110101010101010101
10111111111111111110111101010101010000000000000001010000000000000100010100000000000100000101010101
10100000100000000000000001000101010111111111111101010111110111111101010101111111111111111101010101
10111110101111111111111101010101010100000000000101010100010000000001010100000000000000000000010101
10000000101000000000000001010101010101111111110101010101011111111111010111111111111111111111110101
10111111101010111111111111110101010101010001010100010101010000010000000101000100010001000100000001
10100000001010100000000000000101010101010101010111110101010111010111111101010101010101010101111101
10101111101010101111111111111101010111010111010100000101010101010100000000010101010101010101000001
10100000001010101000000000000001010000000000000101111101010101010111111111110101010101010101011111
10111111111010101111111111111111011111111111111101000001010101010100000000000001010101010101010001
10000000000000100000000000000000000000000000000001000001010101010101111111111111010101010101011101
11111011111111111111111111111111111111111111111111111101010101010100000000000000000100010001000101
10100010000000001010001000100000000000000000000000000000000101010111111111111111111111111111011101
10101010111010101010101010101111111111111111111111111111111101010100000000000000000000000000000001
10111010101010101010101010101000000000000000000000000000000001010101111111111111111111111111111111
10000010101010101010101010101011111111111111111111111111111111010101000000100000100000000000000001
10111110101010100010100010101000000000000000000000000000000000000000001010101110100111111111111111
10000000101010111110101110101111111111111111111111111111111111111111101010101010100000000000000001
11111111101010100000100000001000000000000000000000000000000000000000001010100010101110111111111101
10000000001010111111111111111111111111111111111111111111111111111111111010111110101010100000100001
10111111111010100010001000100000010001000001000010000000000000000000000010000000001010101110101111
10000000000010101010101010101111010101011101011010111111111111111111111111111111111011101010101001
11111111111110101010100010101000010101010101010010100000000001000001000000100000000000001010001001
10000000000000101010111110101011110101010101010110101110111101010101011010101111111111111011101001
10111111111111101010100000001000010101010101010100101010100000010101010010101000100010001000101111
10000000000000001010101101101101010000010100010100101000101111000100010010101010101010101010100001
10111111111111111010101001001001011110010111110111101111101000111101111110101010101010101010111111
10000000000000000000001001001001000000010000000000000000001000000000000000100010001000100010000001
11111111111111111111111111111111111111111111111111111111111111111111111111111111111111111111111131
