110011111111111111111111111111111111111111
110000000000000000000000000000000000000011
110011111111111111111111111111111111110011
110011000000110000000000110000000000000011
110011111111110011001100110011111111110011
110011000000110011001100110011000000110011
110011001100000000001100110011001100110011
110011001111111111111100110011001100110011
110011001100000000000000110011001100110011
110011001100111111111111110011001100000011
110011001100110000000000110011111111111111
110011001100110011001100110011000000110011
110011001100110011001100110011001100110011
110011001100110011001100110011001100110011
110011001100110011001100110011001100110011
110011001100110011001100110011001100110011
110011000000110011001100110011001100110011
110011111111110011001100110011001100110011
110000000000000011001100110000001100000011
1111111111111111111111111111111111111100111